S.T#.....T
#T##..###.
#.###.###E
#E..T.###.
#########G

#.T......T#
#.##..###.#
#T###E###E#
S...T.###.#
#########G#

############
##.T......T#
#.##S.###..#
#T###E###E.#
#...T..E..##
#########G.#
